5,5,5,5,5,5,5,5,5,5,5,5,5,5,5,5,5,5,5,5,5,5,5,5,5,5,5,5,
5,0,0,0,0,0,0,0,0,1,1,1,1,0,0,0,0,0,0,0,0,0,0,0,0,0,0,5,
5,0,0,0,0,0,0,0,0,1,1,1,1,0,0,0,0,0,0,0,0,0,0,0,0,0,0,5,
5,0,0,0,0,0,0,0,0,1,1,0,0,0,0,0,0,2,2,2,2,2,2,0,0,0,0,5,
5,2,2,0,0,1,1,0,0,1,1,0,0,0,0,0,0,0,0,0,0,2,2,0,0,0,0,5,
5,2,2,0,0,1,1,0,0,0,0,0,0,1,1,0,0,0,0,0,0,0,0,0,0,0,0,5,
5,2,2,0,0,1,1,0,0,0,0,0,0,1,1,0,0,0,0,0,0,0,0,0,0,0,0,5,
5,1,1,0,0,1,1,1,1,1,1,0,0,1,1,1,1,0,0,3,3,3,3,0,0,3,3,5,
5,1,1,0,0,1,1,1,1,1,1,0,0,1,1,1,1,0,0,3,3,3,3,0,0,3,3,5,
5,1,1,0,0,0,0,0,0,1,1,0,0,0,0,0,0,0,0,3,3,0,0,0,0,0,0,5,
5,0,0,0,0,0,0,0,0,0,0,0,0,0,0,0,0,0,0,3,3,0,0,0,0,0,0,5,
5,0,0,0,0,0,0,0,0,3,3,3,3,0,0,3,3,3,3,3,3,0,0,1,1,1,1,5,
5,0,0,0,0,1,1,0,0,3,3,3,3,0,0,3,3,3,3,3,3,0,0,1,1,1,1,5,
5,1,1,1,1,0,0,0,0,3,3,1,1,0,0,1,1,1,0,0,0,0,0,0,0,0,0,5,
5,1,1,1,1,0,0,0,0,3,3,1,1,0,0,1,1,1,0,0,0,0,0,0,0,0,0,5,
5,0,0,0,0,0,0,0,0,3,3,0,0,0,0,0,0,0,0,0,0,0,2,2,0,0,0,5,
5,0,0,0,0,0,0,0,0,3,3,0,0,0,0,0,0,0,0,0,0,0,2,2,0,0,0,5,
5,3,3,3,3,3,3,0,0,3,3,0,0,2,2,0,0,1,1,0,0,0,2,0,0,0,0,5,
5,3,3,3,3,3,3,0,0,3,3,0,0,2,2,0,0,1,1,0,0,0,2,0,0,0,0,5,
5,0,0,0,0,0,0,0,0,0,0,0,0,0,0,0,0,0,0,0,0,0,2,1,1,1,1,5,
5,0,0,0,0,0,0,1,1,1,1,0,0,0,0,0,0,0,0,0,0,0,2,1,1,1,1,5,
5,0,0,0,0,0,0,0,0,1,1,1,1,1,1,1,1,1,1,0,0,0,0,0,0,0,0,5,
5,0,0,0,0,0,0,0,0,1,1,0,0,0,0,0,0,1,1,1,1,0,0,0,0,0,0,5,
5,1,1,1,1,1,1,0,0,0,0,0,0,0,0,0,0,0,0,1,1,1,1,0,0,0,0,5,
5,1,1,1,1,0,0,0,0,0,0,0,1,1,1,1,0,0,0,0,0,1,1,0,0,0,0,5,
5,1,1,0,0,0,0,0,0,0,0,0,1,9,9,1,0,0,0,0,0,0,0,0,0,0,0,5,
5,0,0,0,0,0,0,0,0,0,0,0,1,9,9,1,0,0,0,0,0,0,0,0,0,0,0,5,
5,5,5,5,5,5,5,5,5,5,5,5,5,5,5,5,5,5,5,5,5,5,5,5,5,5,5,5,